13	48
16	16
17
0	0	0	0	0	0	0	0	0	0	0	0	0	0	0	0	0	0	0	0	0	0	0	0	0	0	0	0	0	0	0	0	0	0	0	0	0	0	0	0	0	0	0	0	0	0	0	0	
0	0	0	0	0	0	0	0	0	0	0	0	0	0	0	0	0	0	0	0	0	0	0	0	0	0	0	0	0	0	0	0	0	0	0	0	0	0	0	0	0	0	0	0	0	0	0	0	
0	1	2	3	4	5	6	7	8	9	10	11	12	13	14	15	16	17	18	19	20	21	22	23	24	25	0	0	0	0	0	0	26	27	28	0	0	29	30	31	32	33	28	0	34	35	32	36	
0	37	38	39	40	41	42	43	44	45	46	47	48	49	50	0	51	52	53	54	55	56	57	58	59	60	0	0	0	0	0	0	33	61	0	0	29	62	0	0	33	63	0	0	0	64	32	33	
0	37	65	39	66	67	68	69	70	71	72	73	74	75	76	0	77	78	79	80	81	82	83	84	85	86	87	88	89	90	91	92	63	93	94	95	96	97	94	95	30	31	0	96	34	35	32	36	
0	98	99	100	101	102	103	104	105	106	107	108	109	110	111	0	112	113	114	115	116	117	118	119	120	121	122	123	124	125	126	127	128	33	0	97	0	0	0	97	0	0	97	97	0	64	32	33	
0	0	129	130	131	132	0	0	0	133	0	134	135	0	0	0	136	137	138	139	140	141	142	143	144	145	146	147	148	149	150	0	63	93	0	96	94	95	0	29	96	97	96	97	34	35	32	36	
0	0	151	152	153	154	0	0	0	155	156	157	158	0	0	0	159	160	161	162	163	164	165	166	167	168	169	170	171	172	173	0	128	33	0	97	0	97	29	62	0	0	0	0	0	64	32	33	
0	0	174	175	176	177	0	0	0	178	179	180	181	182	0	0	183	184	185	186	187	188	189	190	191	192	193	194	195	196	197	0	26	198	199	0	96	97	96	0	94	95	96	0	34	35	32	36	
0	0	0	200	201	202	203	204	0	205	206	207	208	209	0	0	210	211	212	213	214	215	216	217	218	219	220	221	222	223	0	0	33	224	225	226	0	0	227	226	0	97	227	226	0	64	32	33	
0	0	0	0	0	0	228	229	0	0	0	0	0	0	0	0	230	231	232	233	234	235	236	237	238	239	240	241	242	243	244	0	26	245	246	247	248	248	249	250	248	248	251	247	248	248	32	36	
0	0	252	253	254	255	256	257	258	259	260	261	262	263	0	0	264	265	266	267	268	269	270	271	272	273	274	275	276	277	278	279	33	280	281	282	283	282	283	282	283	282	284	282	283	282	32	33	
0	0	285	286	287	288	289	290	291	292	293	294	295	296	0	0	297	298	299	300	301	302	303	304	305	306	307	308	309	0	0	0	26	27	33	26	310	128	63	93	310	128	33	26	310	128	63	93	
